%%%%%%%%%%%%%%%%%%%%%
%o......%%%%%.......%
%.%%.%%..%%%..%%.%%.%
%.%%.............%%.%
%..%.%%.%% %%.%%.%..%
%...o.. %G G% ..o...%
%..%.%%.%%%%%.%%.%..%
%.%%.............%%.%
%.%%%%%.%%%%%.%%%%%.%
%.........P........o%
%%%%%%%%%%%%%%%%%%%%%
